XXXXXXXXXXX XXXXXXXXX
X     X...........  X
X X XXX.XXXXXXXXX.XXX
X X X...X       X.  X
X X X.XXX XXXXX XXX X
X X X...X X X     X X
X XXXXX.X X X XXXXX X
X.......X   X X     X
X.XXXXXXXXXXX X XXX X
X.....X   X   X   X X
XXXXX.X X X X XXX XXX
X   X.X X   X   X X X
X X X.X XXXXXXXXX X X
X X X.X X       X X X
X XXX X X XXXXX X X X
X   X X   X     X X X
X X X X XXX XXX X X X
X X   X X   X X X   X
X XXXXXXX XXX X XXXXX
X         X         X
XXXXXXXXXXX XXXXXXXXX
