XXXX XXXXXX
XXXX XXXXXX
X         X
X XXXXXXX X
X         X
XXXX XXXXXX
