XXXXXXXXXXXXXXXXXXXXXXXXXXXXXXXXXXXXXXXXXXXXXXXXXXXXXXXXXXXXXXXXXXXXX XXXXXXXXXXXXXXXXXXXXXXXXXXXXXXXXXXXXXXXXXXXXXXXXXXXXXXXXXXXXXXXXXXX
X                   X      ...........X          ...X    .....X  .....X.......X.......X          .....X...........X.....X         X     X
X XXXXXXXXXXX XXXXX XXXXXXX.XXXXXXXXX.X XXXXXXX X.X.XXXXX.XXX.X X.XXX.X.XXXXX.X.XXXXX.XXX XXXXXXX.XXX.X.X XXXXXXX.X.XXX.XXXXXXX XXX X X X
X         X   X   X X...X...X X...  X.X   X...X X.X.....X.X...X X...X...X    ...X    ...X X.......X...X.X X.....X.X.X X.......X     X X X
XXXXXXX XXX XXX X X X.X.X.XXX X.X.XXX.X XXX.X.XXX.XXXXX.X.X.XXXXXXX.XXXXXXXXXXXXXXXXXXX.XXX.XXXXXXX.XXX.XXX.XXX.X.X.X XXXXXXX.XXXXXXX X X
X     X X   X   X X X.X...X   X.X.....X X...X.....X    ...X.X.....X.........X.........X.....X   X...X X...X.X...X.X.X     X X.....X   X X
X XXX XXX XXX X XXX X.XXXXXXX X.XXXXXXXXX.XXXXXXX XXXXXXXXX.X.XXX.X XXXXXXX.X.XXXXXXX.XXXXXXXXX X.XXX X X.X.X.XXX.X.XXX X X XXXXX.X XXX X
X X X     X X X X   X...X     X...X.....X.X X   X X.....X X...X...X     X...X...    X.X X.....  X...X X X...X...X...X   X     X...X   X X
X X XXXXXXX X X X XXXXX.X X XXXXX.X.XXX.X.X X X X X.XXX.X XXXXX.XXXXXXXXX.X XXX.XXXXX.X X.XXX.XXXXX.X X XXXXXXX.XXXXX XXXXXXX X.XXXXX X X
X X       ..X X   X...X.X X   X...X.X X.X.X   X   X.X...X...  X.........X.X X...X.....X...X X...  X.X     X.....X     X       X.X     X X
X XXXXXXXXX.X XXXXX.X.X.X XXX X.XXX.X X.X.XXXXXXXXX.X.XXX.X.XXXXXXXXXXX.X.XXX.XXX.XXXXX.XXX XXX.XXX.XXXXXXX.XXXXXXX XXXXXXX XXX.X XXXXX X
X   X   X...X   X...X...X X   X.....X X.X...X...X...X.X  .X.....  X.....X.....X...X.....    X...X...X.......X     X   X...X X...X X   X X
X X X X X.XXXXX X.XXXXXXXXX X XXXXXXX X.XXX.X.X.X.XXX.XXX.XXXXX.XXX.XXXXX XXXXX.XXX.XXXXXXXXX.XXX.XXX.X XXXXX X X XXX X.X.XXX.XXX X X X X
X X   X X...    X.....X     X X   X   X...X...X...  X...X.X   X.....X   X     X.X X...X X.....X...X  .X X...X X X   X X.X...X.X X   X X X
X XXXXX XXX.XXXXX XXX.X X XXXXX X X X XXX.XXXXXXXXX XXX.X.XXX XXXXXXX X X XXXXX.X XXX.X X.XXX X.XXXXX.XXX.X.XXX XXX X X.XXX.X.X X XXX XXX
X     X   X.....X X...X X       X   X   X.........X   X.X...X       X X   X.....X   X...X...X X.X...X.....X...X X X X X.X...X.X   X X   X
XXXXX XXX XXXXX.XXX.XXXXX XXXXXXXXXXX X XXXXXXXXX.XXXXX.XXX.X XXX X X XXXXX.XXXXX XXXXX.XXX.X X.X.X.XXXXXXXXX.X X X X X.X.X X.XXX X XXX X
X   X   X   X  .....X   X         X   X       X X.......X...X X   X X X.....X     X...X.X X.X X...X.X...X.....X X     X.X.X X...X   X   X
X X XXX XXX X XXXXXXX X XXXXXXXXX X XXXXXXXXX X XXXXXXXXX.XXXXX XXXXX X.XXXXX X XXX.X.X.X X.XXXXXXX.X.X.X.XXXXX XXXXXXX.X.XXXXX.XXX X XXX
X X   X X X X X       X X   X   X X       X X   X     X...X     X     X.X X...X X...X...X X.X.....X...X...X...X.........X.....X...X X   X
X XXX X X X XXX XXXXXXX X X X X X XXXXXXX X XXX XXX X X.XXX XXXXX XXXXX.X X.X.XXX.XXXXXXX X.X.XXX.XXXXXXXXX.X.X.XXXXXXXXXXXXX.XXX.XXXXX X
X   X     X       X   X X X X X       X   X   X     X X...X           X.X X.X.....X...X   X...  X.X.......X.X...X X   X     X...X.......X
XXX XXXXXXXXXXXXXXX X X X X XXXXX XXXXX XXX X XXXXX XXXXX.XXXXXXXXXXX X.X X.XXXXXXX.X.X XXXXXXXXX.X.XXXXX.X.XXXXX X X X X XXXXX.XXXXXXX.X
X X   X             X X X X X   X X     X   X       X   X.X.........X X.X X.........X.  X...X...X...X.....X.....X   X   X     X...X...X.X
X XXX X XXXXXXXXXXXXX X X X X X X X XXXXX XXXXXXX XXX X X.X.XXXXXXX.XXX.X XXXXXXXXXXX.XXX.X.X.X.XXX X.XXX XXXXX.X XXXXXXXXXXX XXX.X.X.X.X
X     X X     X   X   X   X   X X X X   X X     X   X X X.X...X...X.....X.........X...X...X...X...X X...X X   X.X   X       X   X...X...X
XXXXXXX X XXX X X X XXX XXXXXXX XXX X X XXX XXX XXXXX X X.X X.X.X.XXXXXXX.XXXXX X.X.XXX.XXXXXXXXX.X XXX.X XXX X.XXX XXX XXX X XXXXXXXXXXX
X       X X     X X X X X     X   X   X     X X       X X.X X...X.X.....X.X...X X.X...X.X        .X X...X     X.X       X   X           X
X XXXXXXX XXXXX XXX X X X XXX XXX X XXXXXXXXX XXXXXXXXX X.XXXXXXX.X.XXX.X.X.X.XXX.XXX.X.XXX XXXXX.XXX.XXXXXXX X.XXXXXXXXX XXXXXXX XXXXX X
X X   X     X   X   X X X X     X X                   X X.........X.X X...X.X...X.....X...X X...X.....X   X   X.X.....X         X     X X
X XXX X XXX XXXXX XXX X XXX XXX X XXXXXXXXXXX XXXXXXX X XXXXXXXXXXX.X XXXXX.XXX.XXXXXXXXX.XXX.X.XXXXXXX XXX XXX.X.XXX.XXXXXXXXXXXXXXX X X
X   X   X X X     X   X     X X X       X X   X     X X           X...X   X.X X...........X...X.X.....X       X...X X...........X     X X
XXX X XXX X X XXXXX X XXXXXXX X XXXXXXX X X XXX XXX X XXX XXXXXXX XXX.X X X.X XXXXXXXXX XXX.XXX.X.XXX.XXX XXXXXXXXX XXXXXXXXXXX.X XXXXX X
X   X X   X X   X   X X       X X   X   X X   X X   X X X     X   X X.X X X.X           X...X...X.X X...X X.....X...          X.X X   X X
X XXX XXX X XXX XXXXX X X XXXXX X X X XXX XXX X X XXX X XXXXX X XXX X.X X X.XXXXXXXXXXXXX.XXX.XXX.X XXX.X X.XXX.X.X.XXXXXXXXX X.X X X XXX
X X X X   X     X   X X X   X   X X X X       X X   X     X   X     X.X X X.X.............X X.....X   X.X X.X X.X.X.X       X X.X   X   X
X X X X X XXXXXXX X X X XXX X XXX X X X XXXXXXX XXX XXXXXXX XXXXXXX X.XXX X.X.XXXXXXXXXXXXX XXXXXXX X X.XXX.X X.X.X.XXXXX X X X.XXX XXX X
X X X X X X       X   X X X   X X X   X X     X   X         X     X X...X X...X...X               X X X.....X X...X.X...X X   X...X   X X
X X X X X X X XXXXX XXX X XXXXX X XXXXXXX XXX X X XXXXXXXXXXX XXX X XXX.X XXXXX.X.X XXXXXXXXX XXX X XXXXXXXXX XXXXX.X.X.XXXXXXXXX.XXX X X
X X X   X X X   X   X   X       X     X   X X X X X     X       X   X X.X X    .X.X   X X     X X X             X...X.X...X...  X...X X X
X X XXXXX XXXXX XXX X XXXXX XXX XXXXX X XXX X X X X XXX XXX XXXXXXX X X.X X XXX.X.XXX X X XXXXX X XXXXXXX XXXXXXX.XXX.XXX.X.X.X XXX.XXX X
X X     X X   X   X X       X X   X X X X   X X X   X X   X X     X X X.X   X...X...X   X X             X     X...X...  X...X.X X X.X...X
X X XXX X X X X X X XXXXXXXXX XXX X X X XXX X X XXXXX XXX XXX XXX X X X.X XXX.XXXXX.XXXXX XXXXXXXXXXXXX XXXXX X.XXX.XXXXXXXXX.X X X.X.X.X
X X X   X   X X X X X           X X X X   X X X   X   X X     X   X X X.X   X.X   X.....X         X           X.....X X.......X   X...X.X
X X X XXXXXXX XXX XXX XXXXX XXXXX X X XXX X X XXX X X X XXXXXXX XXX X X.XXX X.XXX XXXXX.X XXXXXXX X XXXXXXXXX XXXXXXX X.XXXXXXXXX XXXXX.X
X X X       X X   X   X   X         X X   X   X     X   X       X X X X.X   X...X...X...X X     X X X   X     X     X X.X   X   X X...X.X
X XXXXXXX X X X XXX XXXXX XXXXXXXXX X X XXX XXXXXXXXXXXXX XXXXXXX X X X.X XXXXX.X.X.X.XXX X XXX X XXX X XXX XXX XXX X X.X X X X X X.X.X.X
X X     X X X X     X       X   X   X X   X     X       X   X     X   X.X     X.X.X...X   X X   X     X   X     X   X X.X X   X   X.X.X.X
X X XXX X XXX X XXXXXXX XXXXX X XXXXX X X XXXXX X XXXXX XXX X XXXXXXX X.XXXXX X.X.XXXXX XXXXX X XXXXXXXXX XXXXXXX XXX X.XXXXXXX XXX.X.X.X
X X X     X   X X       X     X       X X X   X X   X       X         X.....X X.X.X...X     X X         X   X   X     X.......X X...X...X
X X X XXXXX XXX XXX XXXXX XXXXXXXXXXXXXXX XXX X X X XXXXXXXXX XXXXXXXXXXXXX.X X.X.X.X.XXXXX X X XXXXXXX XXX X X X XXXXXXXXXXX.X X.XXXXXXX
X X X X     X       X   X     X         X   X   X X   X       X     X   X...X X.X.X.X.X   X X X X   X     X X X   X       X X.X X.X     X
XXX XXX XXXXXXXXX XXX X XXXXX X X XXXXX X X XXX X XXX XXXXXXX XXX X X XXX.XXXXX.X.X.X.X X X X X X X XXXXXXX X XXXXX XXX X X X.XXX.X XXXXX
X   X   X     X   X   X       X X X   X X X   X X X X       X   X X X X...X  ...X...X.X X   X X X X         X   X     X X X X.....X     X
X XXX XXX XXX XXX X XXXXXXXXXXXXX X X X XXXXX X X X XXXXXXX XXX X X X X.XXXXX.XXXXXXX.X XXXXX X X XXXXXXXXXXXXX X XXXXX X X XXXXXXX XXX X
X     X   X     X X   X     X     X X         X X     X   X X     X   X.....X.X.......X       X X     X         X X X   X       X     X X
X XXXXXXX XXXXX XXXXX X XXX X XXXXX XXXXXXXXXXX XXXXX X X X XXXXXXX XXXXXXX.X.X.XXXXXXXXXXXXXXX XXXXX XXX XXXXXXX X X X XXXXXXX XXXXXXX X
X       X   X X   X   X   X   X     X       X   X       X X   X   X X     X.X.X.X         X     X   X   X     X   X X X X   X         X X
XXXXXXX XXX X XXX X XXXXX XXXXX XXXXX XXXXX X XXXXXXXXXXXXXXX X X XXX XXX X.X.X.XXXXXXXXX X XXXXXXX XXX X XXXXX XXX X XXX X XXXXXXXXX X X
X X   X     X   X X   X   X   X   X   X   X X   X             X X X   X X X.X.X.......X   X     X   X X X X         X X   X X   X       X
X X X XXXXXXX X X XXX X XXX X XXX X XXX X X XXX X XXXXXXXXX XXX X X XXX X X.X.XXXXXXX.X XXXXXXX X X X X XXX XXXXXXXXX X XXX X X X XXXXX X
X   X   X     X X     X X   X   X X X   X X X   X X     X   X   X X     X X...X...  X.X           X   X X   X...X...X     X   X X X   X X
XXXXXXX X X XXX XXXXXXX X XXXXX X X X XXXXX X XXX X X XXX XXX XXX XXXXX X XXXXX.X.XXX.X XXXXXXXXXXXXX X X XXX.X.X.X.XXXXXXXXXXX X X X XXX
X       X X X   X   X   X     X   X X     X X   X X X   X   X X X     X X X.....X.....X X.........X X X     X.X.X.X...X.....X   X X X   X
X XXXXXXX X X XXX X X X XXXXX XXXXX X XXX X XXX X XXXXX XXX X X XXX XXX X X.XXXXXXXXXXX X.XXXXXXX.X X XXXXXXX.X.X.XXX.X.XXX.X XXXXX XXX X
X X       X X     X X X X     X   X X   X X   X   X   X X   X X   X X   X X.....X     X X.......X.X X X.......X...X X.X.X...X       X   X
X X XXXXXXX XXX XXXXX X XXXXXXX X X XXXXX XXX XXX X X X X XXX X XXX X XXX XXXXX.X XXXXX XXXXXXX.X.X X X.XXXXXXXXXXX X.X.X.XXX XXXXXXX X X
X X   X   X   X X   X X   X   X X   X   X X   X   X X X   X   X   X X X   X.....X X   X X.......X.X   X.X.....X.....X...X.X X   X X   X X
X XXX XXX XXX XXX X X XXX X X X XXXXX X X X XXXXXXX X XXXXX XXXXX X X X X X.XXXXX X X X X.XXXXXXX.XXXXX.X.XXX.X.XXX.XXXXX.X XXX X X XXXXX
X   X     X X     X     X X X X     X X X X         X     X X     X X X X X.X...X X X X X.X     X...X...X.X X.X.X X.....X.X       X     X
XXX XXXXX X XXXXXXXXXXXXX X X XXXXX X X X XXXXXXXXXXXXXXX X X XXXXX X X X X.X.X.X X X X X.X XXXXXXX.X.XXX.X X.X.X XXXXX.X.XXXXXXXXXXXXX X
X   X   X   X         X   X X     X X X X       X X   X   X   X   X   X X X...X.X   X   X.X        ...X X...X...X   X...X...............X
X X X XXXXX XXXXXXXXX X XXX XXX X X X X X XXXXX X X X X XXXXX X X XXXXX XXXXXXX.XXXXXXXXX.X XXXXXXXXXXX XXX.XXXXXXX X.XXXXXXXXXXXXXXXXX.X
X X   X   X         X X     X X X X   X X   X   X   X X       X X     X       X.......X...X   X...X   X   X.......X X.X.....X.....X.....X
X XXXXX X XXXXXXXXX X XXXXXXX X X XXXXX X X XXX XXXXX XXXXXXXXX XXXXX XXXXX X XXXXXXX.X.XXXXXXX.X.X XXX X XXXXXXX.X X.X.XXX.X.XXX.X.XXXXX
X X     X       X X X         X X X     X X   X     X         X   X       X X   X...X.X.....X...X.X X   X       X.X X...X X...X X...X   X
X X XXXXXXX XXX X X XXXXXXX X X XXX XXXXXXXXX XXXXX XXXXX XXX XXX XXXXXXX X XXXXX.X.X.X XXX.X.XXX.X X XXX XXX XXX.X XXXXX XXXXX XXXXX X X
X X X     X   X   X         X X   X   X       X   X     X X     X X   X   X X.....X.X.X X X.X...X.X   X   X   X...X    ...X...X     X X X
X X X XXX XXX XXX XXXXXXXXXXX XXX XXX XXX XXXXX XXXXXXX XXX X XXX X X X XXX X.XXXXX.X.X X X.XXX.X.X XXX X XXXXX.XXXXXXX.X.X.X.XXX X XXX X
X X X   X     X X X         X X     X   X X           X   X X X   X X X     X...X X...X X X.....X.X   X X X   X...X...X.X...X.X   X   X X
X X XXX XXXXXXX X X XXX XXXXX X XXXXXXX X XXXXXXXXXXX XXX X X X XXX X XXX XXXXX.X XXXXX X XXXXXXX.XXXXX XXX X XXX.X.X.X.XXXXX.X XXXXX X X
X X   X   X     X X X   X     X     X   X   X   X     X   X X X   X X X X X.....X...X     X     X...X   X   X   X...X.X...X X.X     X   X
X XXX XXX X XXX X X X XXX XXXXXXXXX X XXXXX X X X XXX X XXX X XXX X X X X X.XXXXX.X.XXXXX X XXXXXXX.X XXX XXX X XXXXX.XXX.X X.X XXX XXX X
X   X X   X X   X   X X X X   X     X       X X   X   X     X X X   X X   X.X    .X.....X X X...X...X     X X X     X...X.X X.X   X   X X
X X X X XXX XXXXXXXXX X X X X X XXX XXXXXXXXX XXXXXXXXXXXXXXX X XXXXX X XXX.X XXX.XXXXX.X X X.X.X.XXXXX XXX X XXX XXXXX.X.X X.X XXXXX X X
X X   X X           X   X   X X X X X         X     X               X X X...X   X...X X.X   X.X.X.....X     X   X X...X...X X.X X     X X
X XXXXX X XXXXXXXXX XXX X XXXXX X X X XXXXXXXXX XXX X XXXXXXX XXXXXXX X X.XXXXX XXX.X X.XXXXX.X.XXXXX.XXXXXXX X XXX.X.XXXXX X.X X XXXXX X
X   X   X X       X     X X     X X X X   X   X X X X X     X X       X X...X   X...X...X.....X...X...X.....X X.....X.X...  X.X X   X   X
XXX X XXX X XXXXX XXXXXXX X XXXXX X X X X X X X X X X X XXX XXX XXXXX XXXXX.X XXX.XXX.XXX.XXXXXXX.X.XXX.XXX.X XXXXXXX.X.X.XXX.X XXX X XXX
X   X X     X   X     X   X     X X   X X   X   X X   X   X     X   X X.....X X...X...X  .X X.....X.X...X X.X X   X...X.X...X.X X   X   X
X XXX XXXXXXX X X XXXXX XXXXXXX X XXX X XXXXXXXXX XXXXXXX XXXXXXX X X X.XXXXXXX.XXX.XXXXX.X X.XXXXX.X.XXX X.X X X X.XXX.XXX.X.XXX XXXXX X
X   X X   X   X   X     X X     X     X         X   X   X       X X X X...X...X.X  .......X...X    ...X   X.X X X X.....X X...X   X X   X
XXX X X X XXXXXXXXX XXXXX X XXXXXXX XXXXXXXXXXX X X XXX XXXXXXX X X X XXX.X.X.X.XXXXXXXXXXX.XXXXXXX XXXXX X.X X X XXXXXXX XXXXX XXX X XXX
X X X   X       X   X     X   X   X X         X   X   X     X X X X     X...X.X.....X  .....X.....X       X.X   X X   X         X     X X
X X XXXXXXXXXXX X XXXXXXX XXX X X XXX XXXXXXX XXXXXXX XXX X X X X XXXXXXXXXXX.XXX X.XXX.XXXXX.XXX.XXXXXXX X.XXXXX X X X X XXXXXXX XXXXX X
X   X     X X   X           X X X   X       X     X X     X X X X X   X     X...X X...X...X...X X.X.....X X.X X   X X   X   X   X X     X
X XXX XXX X X XXXXXXXXXXXXX X X XXX XXXXXXX XXX X X XXXXXXX X X X X XXX X XXXXX.XXXXX.XXX.X.XXX X.X.XXX.XXX.X X XXXXX XXXXX X XXX X XXX X
X X   X   X X X     X     X X X X   X     X X X X     X     X X X   X   X     X.X...X.X X.X.X X...X...X...X.X X     X X   X X X   X   X X
X XXX X XXX X X XXX X X XXX X X X XXX XXX X X X XXXXXXX XXXXX X XXXXX XXXXX XXX.X.X.X.X X.X.X X.XXXXX.XXX.X.X XXXXX XXX X X X X XXXXX X X
X     X     X     X   X     X   X       X     X               X           X    ...X...X  ...X  .......X  ...X           X   X         X X
XXXXXXXXXXXXXXXXXXXXXXXXXXXXXXXXXXXXXXXXXXXXXXXXXXXXXXXXXXXXXXXXXXXXX XXXXXXXXXXXXXXXXXXXXXXXXXXXXXXXXXXXXXXXXXXXXXXXXXXXXXXXXXXXXXXXXXXX
