XXXXX XXXXX
X         X
X XXXXXXX X
X       X X
X XXXXX XXX
X     X X X
XXXXX X X X
X   X X   X
X XXX XXXXX
X         X
XXXXX XXXXX
