XXXXX XXXXX XXXXX
X               X
X XXXXXXXXXXXXX X
X               X
XXXXX XXXXX XXXXX
